1111111111111111111
10C11000010C1100001
100000000101100C111
1000000111C01011001
100100P001001000001
10000011010000E0011
100C0000010001100C1
1111111111111111111