1111111111111111111
10C0000000000000001
1010101010101010101
10000000000C0000001
1010101010101010101
1000P00000C00000001
1010101010101010101
10000000000E000C001
1010101010101010101
1000C00000000000001
1111111111111111111