1111111111111111111
1000000000C00000001
1011111111111111101
1010000000C00000101
1C101111111111101C1
10100000E000C01C101
1011111111111110101
10000000C00000001P1
1111111111111111111