11111
10C01
10101
10101
1E1P1
11111